11111111111111111111111111111111
1.....1.............1..........1
1.111.1.............1.11111111.1
1.1.1.1.............1.1......1.1
1.1.1.1.............1.1......1.1
1.1.1.1.............1.1......1.1
1.1.1.1.............1.1......1.1
1.1.1.1.............1.1......1.1
1.1.1.1.............1.1......1.1
1.1.1.1.............1.1......1.1
1.1.1.1.............1.1......1.1
1.1.1.1.............1.1......1.1
1.1.1.1.............1.1......1.1
1.1.1.1.............1.1......1.1
131.1.1.............1C1......1.1
131.1.1.............1C1......1.1
131.1.1.............1C1......1.1
131.1.1.............1C1......1.1
131.1.1.............1C1......1.1
131.1.1.............1C1......1.1
131.1.1.............1C1......1.1
131.1.111111111111111111111111.1
1P1.1..........................1
11111111111111111111111111111111